GGGGGGGGGGGGGGGGGGGGGGGGG
GGGGGGGGGGGGGGGGGGGGGGGGG
GGGGGBGGGGGGGGGGGGGGGGGGG
GGGGGGGGGGGGGGGGGGGRGGGGG
GGGGGGGGGAGGGGGGGGGRGGGGG
GGGGGGGGGGGGGGGGGGGRGGGGG
GGGGGGGGGGGGGGGGGGGRGGGGG
GGGGGGGGGGGGGGGGGGGRGGGGG
GGGGGGGGGGGGGGGGGGGRGGGGG
RRRRRRRRRRRRRRRRRRRRRRRRR
GGGGGGGGGGGGRGRGGGGRGGGGG
GGGGGGGGGGGGRRRGGGGRGGGGG
GGGGGGGGGGRRGGGGGGGRGGGGG
GGGGGGGGGGRGGGGGGGGRGGGGG
GGGGGGGGGGRRRRRRRRRRGGGGG
GGGGGGGGGGGGGGGGGGGGGGGGG
GGGGGGGGGGGGGGGGGGGGGGGGG
GGGGGGGGGGGGGGGGGGGGGGGGG
