GGGGGGGGGGGAGGGGGGGGGGGGG
GGGGGGGRRRRRGGGGGGGGGGGGG
GGGGGGGRGGGGGGGGGGGGGGGGG
GGGGGGGRGGGGGGGGGGGGGGGGG
GGGGGGGRRRRRRRRRRGGGGGGGG
GGGGGGGGGGGGGGGGRGGGGGGGG
GGGGGGGGGGGGGRRRRGGGGGGGG
GGGGGGRRRRRRRRGGGGGGGGGGG
GGGGGGRGGGGGGGGGGGGGGGGGG
GGGGGGRGGGGGGGGGGGGGGGGGG
GGGGGGRGGGGGGGGGGGGGGGGGG
GGGGGGRGGGGGGGGGGGGGGGGGG
GGGGGGRGGGGGGGGGGGGGGGGGG
GGGGGGRGGGGGGGGGGGGGGGGGG
GGGGGGRRRRRRRRRRRGGGGGGGG
GGGGGGGGGGGGGGGGRGGGGGGGG
GGGGGGGGGGGRRRRRRGGGGGGGG
GGGGGGGGGGGBGGGGGGGGGGGGG
